00000000000000000000000000000000000000000000000000
00000000000000000000000000000000000000000000000000
00000000000000000000000000000000000000000000000000
00000000000000000000000000000000000000000000000000
00001111111111111111111111111111111111111111110000
00001000000000000000000000000000001000100000010000
00001011111111111011111111111111121011101111010000
00001000101010001000000000100000101010000001010000
00001110100010101011111110101110101000101111010000
00001000111011101000000000101000100010100000010000
00001010001010001011111110111011101010111110110000
00001011011010100010000010001000001010100000010000
00001000000000101011110111101111101110101110110000
00001111101111101000010000101000101000001000010000
00001000101000101011000010000010001003001001010000
00001030001010101011111011011111111000001001010000
00001000101010001000001001010000000011111001010000
00001011100000101011101101010111111010000001010000
00001010111110101000000101010100000000111111010000
00001010100000101011111101010111111110000000010000
00001010101111101010000001010000000000111111010000
00001000001000001010111111011110111110010001010000
00001111111011101010100013000010000011011100010000
00001510401013100010101011111011111110000101110000
00001010001010111110001000000000000000110101010000
00001010000000105011111111011111111111100101010000
00001011110111100000100041010001000000101100010000
00001000000000000010001000000101011113101111110000
00001011111110111111111111011101011111100000010000
00001010000010000000001000001001000000001011010000
00001010111011111111101010101011111111111010010000
00001010131010000000000014100000000000000010110000
00001010101011111110111111111111111011111110010000
00001010001013000000000000004100001013100011010000
00001011111011111111111111111101101010101010010000
00001000000010000000000000000101101010101010110000
00001011111110111111111111110100000000001000010000
00001010001002110001000100010000001010111111010000
00001010101010113100010001010101101010100010010000
00001010101010111111111111010101101010101010110000
00001000100010000000000000010100001010001410510000
00001111111111111111111111111111111111111111110000
00000000000000000000000000000000000000000000000000
00000000000000000000000000000000000000000000000000
00000000000000000000000000000000000000000000000000
00000000000000000000000000000000000000000000000000
00000000000000000000000000000000000000000000000000
00000000000000000000000000000000000000000000000000
00000000000000000000000000000000000000000000000000
00000000000000000000000000000000000000000000000000
